222222222222222222222222
211233333233333211222222
211122222122222111222222
211111111111111111222222
222111111333331122222222
233211111311131233222222
222833111311133922222222
233213111311111233222222
222113333311111122222222
211111111111111111222222
211122222122222111222222
211233333233333211222222
222222222222222222222222