222222222222222222222222
211232112221123211222222
211121133333112111222222
221111331113311112222222
222113311131331122222222
232213111211131223222222
233219112833331233222222
232213111211131223222222
222113311111331122222222
221111331113311112222222
211121133333112111222222
211232112221123211222222
222222222222222222222222