222222222222222222222222
211111122222111111222222
211311112221111311222222
211131111111113111222222
221111111111111112222222
222113331333111122222222
228333131313133392222222
222111133313331122222222
221111111111111112222222
211131111111113111222222
211311112221111311222222
211111122222111111222222
222222222222222222222222