222222222222222222222222
231132221312223113222222
213222222222222231222222
212222122222122221222222
232222212221222223222222
222222333133322222222222
222223323132332222222222
222233113131133222222222
232232113331123223222222
212282122222129221222222
213222211211222231222222
231322222222222313222222
222222222222222222222222