222222222222222222222222
232222223332222223222222
222111122222111122222222
221111111111111112222222
222133333333333122222222
232231121111113232222222
232831222122219232222222
232231121111113232222222
222133333333333122222222
221111111111111112222222
222111122222111122222222
232222223332222223222222
222222222222222222222222