222222222222222222222222
222111111111111122222222
222133333133333122222222
221131113131113112222222
221131113131113112222222
211133333933333111222222
211113111111131111222222
211113131113131111222222
221113111111131112222222
221113111811131112222222
222113333333331122222222
222211111111111222222222
222222222222222222222222