222222222222222222222222
223221111111111111222222
232211333333333331222222
222111313131313131222222
232211333333333331222222
223221313131313131222222
232933333333833331222222
223221313131313131222222
232211333333333331222222
222111313131313131222222
232211333333333331222222
223221111111111111222222
222222222222222222222222