222222222222222222222222
233323222222232333222222
233322222222222333222222
233222222822222233222222
222232223332223222222222
232222233133222223222222
222222231113222222222222
222222333333322222222222
222222311111322222222222
222223333333332222222222
232223111111132223222222
223223333933332232222222
222222222222222222222222